R     1500        12000

NO ./pics/sunset1.xpm
SO ./pics/sunset2.xpm
WE ./pics/sunset3.xpm

S ./pics/pillar.xpm
F 24,54,67
C       254,191,255

EA ./pics/sunset4.xpm


 111111111111111111111111111
10000000001000000000001
10000000000000000000011
10011100000000000000011
10000011111000020202001
10000010001000000000000111
100000100010000000000021
11111111001000000000011111111
100000110110000000000001
100000000000001110000001
100002000000001010000001
100000000000001110000001
10000001111111111111111
100000000000000000000001
100000000000011111111111
100000000000000000000001
1111111110000000N0000001
110100001000000002000001
110000201000000000000001
110000000000000000000001
110111111000000000000001
110000000000000000000001
111111111000100000000201
11111 11111111111111111
